<height>
9
<map>
1111111111111
1200000000131
1010101010101
1010101010101
1010101000101
1010101010101
1000000010001
1000000010001
1111111111111
<monster>
1
1,2
1,6
</monster>
<monster>
1
2,1
9,1
</monster>
<monster>
1
7,7
7,4
9,4
9,7
</monster>
