<height>
9
<map>
1111111111111
1301010000101
1000001010101
1001001010101
1001000010001
1001001010101
1000001011101
1001001011201
1111111111111
<monster>
0
2,2
4,2
4,6
2,6
</monster>
<monster>
1
11,1
11,6
</monster>
<monster>
1
7,1
7,7
</monster>