<height>
10
<map>
11111111111111111
12000000000000001
10000000000000001
10000000000000001
10000000000000001
10000003000000001
10000000000000001
10000000000000001
10000000000000001
11111111111111111
<monster>
1
1,2
2,2
2,1
</monster>
<monster>
0
6,4
6,6
8,6
8,4
</monster>