<height>
9
<map>
1111111111
1111101111
1111101111
1111101111
1200000003
1111101111
1111101111
1111101111
1111111111
<monster>
1
5,1
5,7
</monster>