<height>
10
<map>
11111111111111111
12000000000000001
10000000000000001
10000000000000001
10000000000000001
10000000000000001
10000000000000001
10000000000000001
10000000000000001
13111111111111111
<monster>
0
1,2
15,2
</monster>
<monster>
0
15,3
1,3
</monster>
<monster>
0
1,5
15,5
</monster>
<monster>
0
15,6
1,6
</monster>
<monster>
0
1,8
15,8
</monster>