<height>
10
<map>
11111111111111111
12000000000000001
11111111001010101
10000000000000001
10111110111100101
10000000000000001
11110001010100001
10000000000000001
10001000100000001
13111111111111111
<monster>
1
3,8
3,7
5,7
5,8
7,8
</monster>
<monster>
0
13,3
15,3
15,5
13,5
</monster>